32,3,90
60,40
000000000000000000000000000011111100000000000000000000000000
000000000000000000000000001100000011000000000000000000000000
000000000000000000000000001100000011000000000000000000000000
111111111111111111111111111100000011111111111111111111111111
000000000000000000000011111100000011111100000000000000000000
000000000000000000000011000000000000001100000000000000000000
000000000000000000000011001100000011001100000000000000000000
111111111111111111111111001111111111001111111111111111111111
100000000000000000000011000000000000001100000000000000000001
100000000000000000000011111100000011111100000000000000000001
100000000000000000000000000000000000000000000000000000000001
100000000000000000000000000007770000000000000000000000000001
166666555544443333222000000077777000000666665555444433332221
000000000000000000002000000007770000000600000000000000000000
000000000000000000002000000000000000000600000000000000000000
000000000000000000002000000000000000000600000000000000000000
000000000000000000002000000000000000000600000000000000000000
000000000000000000003000000000000000000500000000000000000000
000000000000000000003000000000000000000500000000000000000000
000000000000000000003000000000000000000500000000000000000000
000000000000000000003000000000000000000500000000000000000000
000000000000000000003000000000000000000500000000000000000000
000000000000000000003000000000000000000500000000000000000000
000000000000000000003000000000000000000500000000000000000000
000000000000000000003000000000000000000500000000000000000000
000000000000000000003000000000000000000500000000000000000000
000000000000000000030000000000000000000050000000000000000000
000000000000000000230000000000000000000005000000000000000000
000000444444400001200000000000000000000000055555555444443333
666666600000111111000000000000000000000000000000000000000001
100000000000000000000000000000000000000000000000000000000001
100000000000000000000000000007770000000000000000000000000001
100000000000000000000000000077777000000000000000000000000001
100000000000000000000000000007770000000000000000000000000001
111111000000000000000000000000000000000000000000000011100111
100001000000000000000000000000000000000000000000000010000001
100001000000000000000000000000000000000000000000000010000001
000001111111111111111111111111111111111111111111111110000000
000000000000000000000000000000000000000000000000000000000000
111111111111111111111111111111111111111111111111111111111111
/usr/share/pixmaps/faces/yellow-rose.jpg
/usr/share/pixmaps/faces/sunflower.jpg
/usr/share/pixmaps/faces/mountain.jpg
/usr/share/pixmaps/faces/penguin.jpg
/usr/share/pixmaps/faces/plane.jpg
/usr/share/pixmaps/faces/puppy.jpg
/usr/share/pixmaps/faces/sky.jpg
/usr/share/pixmaps/faces/sunflower.jpg
/usr/share/pixmaps/faces/sunset.jpg
/usr/share/pixmaps/faces/surfer.jpg
/usr/share/pixmaps/faces/tomatoes.jpg
/usr/share/pixmaps/faces/tree.jpg
/usr/share/pixmaps/faces/yellow-rose.jpg
